*....*.....*..*.....*....*
*....*.....*..*.....*....*
*....*.....*..*.....*....*
X****X**X**X**X**X**X****X
*....*..*........*..*....*
*....*..*........*..*....*
X****X..X**X..1**X..X****X
.....*.....*..*.....*.....
.....*.....*..*.....*.....
.....*..X**X..X**X..*.....
.....*..*........*..*.....
.....*..*........*..*.....
.....X**X........X**X.....
.....*..*........*..*.....
.....*..*........*..*.....
.....*..X********X..*.....
.....*..*........*..*.....
.....*..*........*..*.....
X****X**X**X..X**X**X****X
*....*.....*..*.....*....*
*....*.....*..*.....*....*
X*X..X**X**X**X**X**X..X*X
..*..*..*........*..*..*..
..*..*..*........*..*..*..
X*X**X..X**X..X**X..X**X*X
*..........*..*..........*
*..........*..*..........*
X**********X**X**********X